1111111111111111111111111111
1000000010000000000010000001
1110000010000000000010000001
  100000110001000000000001111111
  100000010111111111000000000001
  100000000100001000000011111111
  10000000010000000N00001
  11111111111111111111111