1111111111111111
1000000000000001
1110000000000111
  100000001001
  100000001001
  111111111111